> JagFX C:\path/to\sound_file.synth
------------------------------------------------------------------------------------------------------------------------------------------------------------------------------------------------------------------------------------|
            |---------------------------------------------------------------------------------------------------------------------------------------------------------------------------------------------------------------------- |
            | /Freq Base          [1x][2x][4x][..][M..][↓]/---------| /Freq Mod rate      [1x][2x][4x][..][M..][↓]/           /Freq Mod range     [1x][2x][4x][..][M..][↓]/           /Graph of poles and zeros   [1x][2x][4x][..]/ |
[Off]       | /===========================================/[Off]    | /===========================================/           /===========================================/           /===========================================/ |
[Sqr]       | /                                           /[Sqr]    | /                                           /           /                                           /           /                                           / |
[Sin]       | /                                           /[Sin]    | /                                           /           /                                           /           /                                           / |
[Saw]       | /                                           /[Noise]  | /                                           /           /                                           /           /                                           / |
[Noise]     | /                                           /Min Hz:  | /                                           /           /                                           /           /                                           / |
Min Hz:     | /                                           /    0  ^ | /                                           /           /                                           /           /                                           / |
    0  ^    | /                                           /         | /                                           /           /                                           /           /                                           / |
Max Hz:     | /                                           /Max Hz:  | /                                           /           /                                           /           /                                           / |
    0  ^    | /                                           /    0  ^ | /                                           /           /                                           /           /                                           / |
Av Hz:      | /                                           /         | /                                           /           /                                           /           /                                           / |
    0       | /                                           /Av Hz:   | /                                           /           /                                           /           /                                           / |
------------| /                                           /    0    | /                                           /           /                                           /           /                                           / |
            | /===========================================/---------| /===========================================/           /===========================================/           /===========================================/ |
------------|                                                                                                                                                                                                                       |
Len ms:     | /Amp Base           [1x][2x][4x][..][M..][↓]/---------| /Amp Mod rate       [1x][2x][4x][..][M..][↓]/           /Amp Mod range      [1x][2x][4x][..][M..][↓]/           /Transition Curve   [1x][2x][4x][..][M..][↓]/ |
    0  ^    | /===========================================/[Off]    | /===========================================/           /===========================================/           /===========================================/ |
Pos ms:     | /                                           /[Sqr]    | /                                           /           /                                           /           /                                           / |
    0  ^    | /                                           /[Sin]    | /                                           /           /                                           /           /                                           / |
L1 ms       | /                                           /[Noise]  | /                                           /           /                                           /           /                                           / |
    0  ^    | /                                           /Min Hz:  | /                                           /           /                                           /           /                                           / |
L2 ms       | /                                           /    0  ^ | /                                           /           /                                           /           /                                           / |
    0  ^    | /                                           /         | /                                           /           /                                           /           /                                           / |
------------| /                                           /Max Hz:  | /                                           /           /                                           /           /                                           / |
[Play]      | /                                           /    0  ^ | /                                           /           /                                           /           /                                           / |
[Play All]  | /                                           /         | /                                           /           /                                           /           /                                           / |
[Loop]      | /                                           /Av Hz:   | /                                           /           /                                           /           /                                           / |
[Loop All]  | /                                           /    0    | /                                           /           /                                           /           /                                           / |
            | /===========================================/---------| /===========================================/           /===========================================/           /===========================================/ |
------------|                                                                                                                                                                                                                       |
Loops:      | /Final Output       [1x][2x][4x][..][M..][↓]/---------| /Gap off            [1x][2x][4x][..][M..][↓]/           /Gap on             [1x][2x][4x][..][M..][↓]/           /Frequency Response         [1x][2x][4x][..]/ |
    0  ^    | /===========================================/[Off]    | /===========================================/           /===========================================/           /===========================================/ |
------------| /                                           /[On]     | /                                           /           /                                           /           /                                           / |
[Stop]      | /                                           /Min Gap: | /                                           /           /                                           /           /                                           / |
[Load]      | /                                           /    0  ^ | /                                           /           /                                           /           /                                           / |
[Save]      | /                                           /         | /                                           /           /                                           /           /                                           / |
            | /                                           /Max Gap: | /                                           /           /                                           /           /                                           / |
[True Wave] | /                                           /    0  ^ | /                                           /           /                                           /           /                                           / |
            | /                                           /         | /                                           /           /                                           /           /                                           / |
            | /                                           /Av Gap:  | /                                           /           /                                           /           /                                           / |
            | /                                           /    0    | /                                           /           /                                           /           /                                           / |
            | /                                           /---------| /                                           /           /                                           /           /                                           / |
            | /                                           /           /                                           /           /                                           /           /                                           / |
            |-/===========================================/-----------/===========================================/-----------/===========================================/-----------/===========================================/ |
                                                                      \Harmonic 1     \ \Harmonic 2     \ \Harmonic 3     \ \Harmonic 4     \ \Harmonic 5     \                                                                     |
                Editing Tone                                          \ Semi:    0  ^ \ \ Semi:    0  ^ \ \ Semi:    0  ^ \ \ Semi:    0  ^ \ \ Semi:    0  ^ \ \ Reverb              \                                Mode         |
[ 1][ 2][ 3][ 4][ 5][ 6][ 7][ 8][ 9][10][Copy]                        \ Vol :    0  ^ \ \ Vol :    0  ^ \ \ Vol :    0  ^ \ \ Vol :    0  ^ \ \ Vol :    0  ^ \ \ Reverb vol:    0  ^ \                                             |
                                                                      \ Del :    0  ^ \ \ Del :    0  ^ \ \ Del :    0  ^ \ \ Del :    0  ^ \ \ Del :    0  ^ \ \ Reverb del:    0  ^ \                        [Main][Filter][Both] |
               [Reset Active]                                         \===============\ \===============\ \===============\ \===============\ \===============\ \=====================\                                             |
------------------------------------------------------------------------------------------------------------------------------------------------------------------------------------------------------------------------------------|
